36 18 0
2 2 2 2 2 2 2 2 2 2 2 2 2 2 2 2 2 2 2 2 2 2 2 2 2 2 2 2 2 2 2 2 2 2 2 2
2 1 1 1 1 1 2 1 1 1 2 2 1 1 1 2 1 2 1 2 2 2 2 1 1 2 4 2 2 2 1 1 1 1 2 2
2 2 5 1 1 2 2 2 1 1 1 1 1 1 2 2 1 1 1 2 2 2 1 1 1 1 1 1 2 2 2 2 2 1 1 2
2 1 1 1 2 2 1 2 1 1 1 2 1 1 1 1 1 1 1 1 1 2 1 1 2 1 2 1 2 2 1 1 1 1 1 2
2 1 1 1 1 2 1 1 1 1 1 2 1 1 2 1 1 1 1 5 2 2 2 2 2 2 2 1 1 1 1 2 2 2 1 2
2 2 2 2 1 1 1 2 2 1 1 1 1 1 2 1 1 1 1 1 1 1 2 2 2 2 2 2 2 1 5 2 2 1 1 2
2 1 1 1 1 2 1 1 1 1 1 1 1 2 2 1 1 2 2 2 2 1 2 1 1 1 1 1 2 1 1 1 1 1 2 2
2 1 2 1 1 2 2 2 2 1 1 1 2 2 2 1 1 1 1 2 2 1 2 1 2 2 2 1 1 1 1 1 2 2 2 2
2 1 2 1 1 1 1 1 1 1 1 1 1 1 1 1 1 1 1 1 1 1 1 1 1 1 1 1 2 2 1 2 2 1 2 2
2 2 2 1 1 1 1 1 1 1 2 2 2 1 1 1 1 1 1 1 1 2 2 1 1 1 2 2 2 1 1 1 1 1 1 2
2 1 1 1 1 1 2 5 1 1 1 1 2 2 2 2 2 2 1 1 1 1 2 1 1 1 1 2 1 1 1 2 2 1 1 2
2 1 1 1 1 1 2 1 1 1 2 1 1 1 2 1 1 1 1 1 1 1 2 2 2 1 1 2 1 1 1 2 1 1 2 2
2 1 1 2 2 2 2 1 1 2 2 1 1 1 2 2 2 1 1 1 1 1 1 1 1 1 1 2 1 1 1 1 1 1 1 2
2 1 1 2 1 1 1 1 1 2 2 2 2 1 1 1 2 1 1 2 2 2 2 1 1 1 2 2 2 2 2 2 1 2 2 2
2 1 1 1 1 1 1 1 2 2 1 1 1 1 1 1 1 1 1 1 1 1 1 1 1 1 1 1 1 1 1 1 1 1 1 2
2 1 2 1 1 2 1 1 1 1 1 1 2 2 2 2 1 1 1 1 1 1 1 1 1 1 1 1 1 1 1 1 2 2 2 2
2 3 2 1 1 2 1 1 1 1 1 1 1 1 1 2 1 1 1 2 2 2 1 1 1 1 5 2 2 2 2 1 1 1 1 2
2 2 2 2 2 2 2 2 2 2 2 2 2 2 2 2 2 2 2 2 2 2 2 2 2 2 2 2 2 2 2 2 2 2 2 2
